1111111111111111111111111111111111
1P000C111000C111111111100000C11111
1010000010000011111100110000000111
101100000000000110000011100C000011
10010000000000010000C001100000C011
100110000000000C000000001000001111
100111000000000C000000011000011111
1C00111000000001000000110000011101
1100001100000001100000000000001001
1110000111000000110000000100000001
1110000110000001111100000110000001
111C000100000011001100000111000001
1100000C100C011000C100000011110E01
110000011000011000110000000C111111
1C0000111100000011111000000CC11111
1111111111111111111111111111111111
