111111111111
1E00C0000001
111110000001
10P010001001
100010011001
100000001101
101110000101
100111000001
111111111111
