11111111111111111111111
2E00C000000200C00000002
20000000000200000000002
20P00000000200000000002
20000000000200000000002
20000000220200000002202
20222200000000000002002
20000000000200000002202
22222222222222222222222